NO ./images/greystone.xpm
SO ./images/mossy.xpm
WE ./images/eagle.xpm
EA ./images/wood.xpm
F 92, 101, 104
C 46, 50, 52
        1111111111111111111111111
        1000000000110000000000001
        1011000001110000000000001
        1001000000000000000000001
111111111011000001110000000000001
100000000011000001110111111111111
11110111111111011100000010001
111101111111110111010100000011111
11000000110101011100000010000001
100000000000000000000000100011111
100E0000000000000001010010001
1100000111010101111101111000111
11110111 1110101 101111010001
11111111 1111111 111111111111
