NO ./images/greystone.xpm
SO ./images/mossy.xpm
WE ./images/eagle.xpm
EA ./images/wood.xpm
F 92, 101, 104
C 46, 50, 52
         11111111111111111111111
        1000000000110000000000001
        1011000001110000000000001
        1001000000000000000000001
111111111011000001110000000000001
10000000001100000111011111111111
11110111111111011100000010001
11110111111111011101010000001111
110000001101010111000000100000001
10000000000000000000000100011111
10000000000000N0001010010001
1100000111010101111101111000111
11110111 1110101 101111010001
11111111 1111111 111111111111
